菜单配置->标题，链接，图片，父级标题，菜单类型，顺序，显示名称

角色菜单->角色名称，菜单标题
用户角色->角色名称，登录名
角色配置->角色名称，所属组织
用户信息->登录名，密码，用户类型，用户级别，状态，昵称，真实姓名，头像，所属部门，电话，照片
用户信息.状态=>正常，已停用=>停用
登录记录->登录名，登录时间
用户菜单->登录名，标题
党员信息管理->姓名，身份证号，出生日期，性别，民族，学历，类别，所在党支部，入党日期，转正日期，工作岗位，联系电话，家庭住址
党费管理->姓名，身份证号，年龄，所在党支部，月收入，月党费
党课记录->姓名，身份证号码，课程名称，课程摘要，学习情况，课程时间
三会一课->日期，主题，参与人员，与会人数，主持人，内容，类型
专题学习->日期，专题内容，参与人员，与会人数，主持人，内容
政策文件->文件号，@政策文件类别，专文件主题，内容，上传文件，年份
政策文件类别->类别名称，描述

现役军人名单->姓名，民族，家庭住址，身份证号码，联系方式，家庭情况，备注，性别，出生年月，文化程度，户口所在地
征兵对象名单->姓名，出生年月，文化程度，政治面貌，户口性质，毕业院校，联系方式，身份证号码，备注
共青团->序号，姓名，性别，出生年月，志愿时间，籍贯，学历，入团年月，备注

重点人员->序号，姓名，性别，居住地，户籍地，事由，目前状态，联系电话，备注
信访->序号，投诉事件，投诉地点，办理结果
两类人员->所在社区，姓名，性别，身份证号码，罪名，家庭住址
家庭->家庭组织名称，姓名，身份证号码，新生儿姓名，死亡证明，居住地，联系方式
股民->序号，户编号，股权证编号，身份证号码，户主，姓名，性别，出生年月，周岁，基本股，应得股份股，户合计股数，确认签名，配股说明，统计主题1
分红记录->姓名，身份证号码，股份类型，股票占比，发放金额，发放时间，负责人，负责人联系方式
干部->姓名，身份证号码，上级领导，所属支部，劳模，干部类型
民兵->姓名，身份证号码，上级领导，所属番号，民兵类型
统战民兵->姓名，身份证号码，上级领导，所属番号，民兵类型
厂房楼栋->工业园名称，序号，承租户，起止，承租面积，押金，单价，月租金，年租金，租凭单位性质，环保手续，建筑面积，开始时间，结束时间，联系人，联系电话，审批文件，楼号，单元号，门牌号，负责人，负责人联系方式，范围，备注，地址
收租记录->企业名称，负责人，负责人电话，付款金额，收款人，收款人电话，收款金额，收款时间，应收款时间，备注,工业园名称
电费缴纳记录->企业名称，负责人，负责人电话，付款金额，收款人，收款人电话，收款金额，收款时间，应收款时间，备注
工作日志->序号，条线，负责人，日期，办理事项，是否完成，完成时间，备注
通知->标题，内容，作者，通知发送日期，通知发送对象，备注，摘要，图片
文档管理->标题，内容，作者，原件图片，备注
人口->公民身份号码，姓名，性别，出生日期，居村委会，住址，年龄
新生儿->公民身份号码，姓名，性别，出生日期，居村委会，住址，年龄
房产->身份证，地址，楼栋号，单元号，门牌号
报销清单->姓名，出发位置，目的地位置，交通费，住宿费，住勤补贴，公交费，报销日期
通讯录->机构名称，人员姓名，身份证，性别，电话，手机，邮箱，职位，上级领导，QQ，微信
Poi->地址
党建要闻管理->标题，内容，作者，发布时间，类别，图片
随手拍->内容，设备，用户ID，照片，拍照时间，位置，姓名，电话，区域，点赞数目
主动巡检->巡检问题，创建时间，状态，用户，区域，图片，位置
业务预约->业务，服务，姓名，身份证，电话，创建时间，受理时间，状态
业务预约.状态=>已预约，已处理=>查看，处理
提建议记录->标题，内容，对象，处理人，处理日期
党风廉政学习->标题，内容，学习对象，学习日期，备注
公共设施->名称，位置，类型，归属，换新日期，是否损坏
系统配置->标题，分类，子分类，内容，是否生效
党建->标题，内容，发布时间，备注
党费缴纳管理->姓名，电话，金额，日期，收款人，所属支部
合同管理->合同编号，合同名称，项目名称，甲方签名，乙方签名，丙方签名，签署日期，签署机构，合同文件上传
个人信息->登录名，昵称，真实姓名，密码，头像，上次登录时间，所属部门，电话，照片
日程工作->标题，内容，地点，负责人，电话，开始时间，结束时间
党建专题->标题，预览，发布时间，查看
办事指南->类别，办事内容，所需材料，办事程序
党务指南->标题，内容，类别，适用范围
业务管理->业务类型，服务类型，申请人，身份证，性别，大厅受理时间，经办人，创建时间，状态
业务管理.状态=>已登记，待办，已办=>派发，处理
少儿医保->单位编号，人员编号，姓名，身份证，出生日期，免缴种类，免缴号码，联系人，联系电话
农村医疗->人员编号，姓名，身份证，免缴种类，免缴号码，联系人，联系电话，区域，操作
福利发放->姓名，性别，年龄，身份证号，福利类型，发放金额，发放日期，被保人id，住址，区域，操作
服务预约->服务类型，预约人，预约时间，身份证，创建时间，审核时间，状态，审核登记
服务预约.状态=>已登记，已处理=>处理
日程管理->活动类型，开始日期，结束日期，内容，地点，负责人，电话，备注
专家管理->技术特长，姓名，性别，出生日期，身份证，地址，联系电话
权限访问->姓名，访问时间
便民指南->标题，发布时间，图片，内容，摘要，备注
便民生活->标题，发布时间，图片，内容，摘要，备注
香溪特色->标题，发布时间，图片，内容，摘要，备注
建议处理->标题，内容，对象，处理人，处理日期，姓名，身份证，电话，创建时间，状态
建议处理.状态=>已登记，已处理=>新增，处理
村史->菜单项，主标题，副标题，图片，摘要
专项工作->工作主题，工作内容，开始日期，结束日期，状态，照片
视频点位信息->序号，监控点名称，监控点编号，所属组织，所属区域，所属平台，经度，纬度，地址
就业援助->个人编号，姓名，身份证号码，性别，民族，年龄，文化程度，户口性质，是否残疾，培训意愿，联系方式，人员类型，就业形式，内容1，内容2，内容3，内容4
危房解危->所有权人，房屋座落，房产证面积，土地证面积，测绘面积，测绘增补面积，安置面积，签字时间，交房时间，补偿金额，联系电话，现居住地址
工业园房屋收款->@厂房楼栋，开始时间，结束时间，付款金额
需求收集->您需要什么内容，期望交付时间，您的姓名，您的联系方式
党组织信息管理->党组织名称，党组织书记，党组织联系人，党组织联系电话，组织类别，上级党组织名称，党组织书记公民身份号码
关爱对象->姓名，性别，类型，身份证，户口所在地，常住地，楼栋号，单元号，门牌号
招聘就业模块->用人单位，职位，发布人，职位描述，职位职责内容，职位要求内容，生效时间，失效时间
党群结队->所属党组织，成员姓名，身份证号码，创建时间
党员活动->活动名称，活动简介，覆盖范围，活动照片
美丽乡村->年份，月份，标题，照片，建设成果
引水上山->年份，月份，标题，照片，建设成果
宣传->标题，类别，子类别，内容，地址
组织->成员编号，姓名，上级，组织名称，所属支部，地址
工会->单位组织机构代码，单位或单位主体的国民经济行业分类代码，单位或单位主体的单位类别，单位地址，上级工会，单位工会名称，建会时间，工会负责人，工会负责人联系电话，工会办公电话，本单位已交至苏州银行的会员身份证复印件数量，单位职工总数人，单位会员数人，单位女职工数人，单位女会员数人，统计主题1
工会成员->姓名，性别，民族，出生年月，政治面貌，学历，籍贯XX省XX市，入会时间，身份证号，地址单位地址，手机号码，身份证有效期限，是否从事有毒有害工作是否，备注1,
工作人员->员工编号，上级，负责区域，所属条线，地址
姑苏村问题处理->问题编号，问题描述，问题类别，照片，负责人，问题状态，确认时间，处理时间，回访时间
渔政->渔证编号，持证人姓名，发证日期，下次换证日期，负责人，地址，是否有效
妇联执委名单->序号，姓名，出生年月，职务，性质
资产->资产编号，资产名称，资产类别，会计科目，所属单位


监护人->姓名，性别，联系电话，户籍所在地，所在地区，详细地址，居住地，提交人，提交人电话，社保卡正反面，监护人身份证正反面
照片->类别，url，物理地址，社保卡反面，社保卡正面，监护人身份证正面，监护人身份证反面，其他